																		
#	#	#	#	#	#	#	#	#	#	#	#	#	#	#	#	#
#							P									#
#				W			X	W				W				#
#							 	 	 							#
#								X	 	 						#
#								X								#
#				W				W				W				#
#																#
#																#
#																#
#				W				W				W				#
#																#
#																#
#																#
#				W				W				W				#
#																#
#	#	#	#	#	#	#	#	#	#	#	#	#	#	#	#	#
