'XXXXXXXXXXXXXXXXXXXXXXXXXXXX'
'                            ',
'                            ',
' XX    XXX            XX    ',
' XX                          ',
' XXXX         XX         XX ',
' XXXX       XX              ',
' XX    X  XXXX    XX  XX    ',
'       X  XXXX    XX  XXX   ',
'    XXXX  XXXXXX  XX  XXXX  ',
'XXXXXXXXXXXXXXXXXXXXXXXXXXXX'