'XXXXXXXXXXXXXXXXXXXXXXXXXXXX'
'X                          X',
'X                          X',
'XX    XXX            XX    X',
'XX                         X',
'XXXX         XX          XXX',
'XXXX       XX              X',
'XX    X  XXXX    XX  XX    X',
'X       X  XXXX    XX  XXX X',
'X   XXXX  XXXXXX  XX  XXXX X',
'XXXXXXXXXXXXXXXXXXXXXXXXXXXX'